#####################
#     #       #     #
# ### # ##### # ### #
# #   #     # # #   #
# # ####### # # # ###
# #       # # # #   #
# ####### ### # ### #
#       #           #
##### # ####### #####
#A    #     #       B
#####################
